{
"Name": "Level6",
"Layout": [
"###### ##### ",
"#    ###   # ",
"# **     #@# ",
"# * #...   # ",
"#   ######## ",
"#####        "
]
}