{
"Name": "Level8",
"Layout": [
"  ######",
"  # ..@#",
"  # ** #",
"  ## ###",
"   # #  ",
"   # #  ",
"#### #  ",
"#    ## ",
"# #   # ",
"#   # # ",
"###   # ",
"  ##### "
]
}