{
  "Name": "Level10",
  "Layout": [
  "      ##### ",
  "      #.  # ",
  "      #.# # ",
  "#######.# # ",
  "# @ * * * # ",
  "# # # # ### ",
  "#       #   ",
  "#########   "
  ]
}